,
  [
      ["█","█","█","█","█","█","█","█","█","█"],
      ["█","░","░","░","░","░","░","░","░","█"],
      ["█","░","░","░","░","░","░","░","░","█"],
      ["█","░","░","░","░","░","░","░","░","█"],
      ["█","░","░","░","░","░","░","░","░","█"],
      ["█","░","░","░","░","░","░","░","░","█"],
      ["█","░","░","░","░","░","░","░","░","█"],
      ["█","░","░","░","░","░","░","░","░","█"],
      ["█","□","░","░","░","░","░","░","░","█"],
      ["█","█","█","█","█","█","█","█","█","█"]
  ]
